----------------
-+2+++++3+++++p-
-*------1-------
-++++++++++++++-
------+++-------
-+++++t++++++2+-
-+--------------
-++++4+++++g+++-
----*---------+-
-+++++m+++++3++-
-+-----+3-------
-++++++2+++4+++-
---+----------+-
-p+++m+++++g+tk-
----------------