----------------
-+2+++++++++++p-
-*------1-------
-++++++++++++++-
------+++-------
-+++++t++++++2+-
-+--------4-----
-++++4+++++++++-
--------------+-
-+++++m+++++3++-
-+--------------
-++++++2+++4+++-
--------------+-
-p+++m+++++g+tk-
----------------