----------------
-+2+++++++++++p-
-+--------------
-++++++++++++++-
------+++-------
-+++++t++t+++2+-
-+--------------
-++++++++++++++-
--------------+-
-++++++++++++++-
-+--------------
-++++++2+++++++-
--------------+-
-p+++m+++1+++tk-
----------------