----------------
-+2+++++++++++p-
-+------1-------
-++++++++++++++-
------+++-------
-+++++t++t+++2+-
-+--------------
-++++4+++++++++-
--------------+-
-++++++++++++++-
-+--------------
-++++++2+++4+++-
--------------+-
-p+++m+++++g+tk-
----------------