----------------
-+2++++++t++++p-
-+------1-------
-++++++++++g+++-
------+++-------
-+++++t++++++2+-
-+--------4-----
-++++4+++++++++-
--------------+-
-+++++m+++++3++-
-+--------------
-++++++2+++4+++-
--------------+-
-p+++m+++++g+tk-
----------------