----------------
-1+++++t++++t+p-
-+--------------
-+++++mmm++++++-
------+++-------
-++++++t+++++++-
-+--------------
-++2+++++++++++-
-------m------+-
-++++2++m++++++-
-+--------------
-++++++m+++++++-
--------------+-
-p+++<+++2++++k-
----------------