----------------
-+2+++++++++++p-
-+--------------
-++++++++++++++-
------+++-------
-+++++t++t+++2+-
-+--------------
-++++g+++++++++-
--------------+-
-++++++++++++++-
-+--------------
-++++++2+++g+++-
--------------+-
-p+++m+++1+++tk-
----------------