----------------
-+m++---mmm-++1-
-+2++t+++++++tt-
-+---++++++++++-
-+++----p----++-
-+t++++---m++++-
-+++t++++++2+++-
-2--+++++--++t+-
-++-------+++++-
-t+++++++++m--+-
-++++2++m+---++-
-+++++-----++++-
-+2+---++++++tt-
-k+t++++---m++p-
----------------