----------------
-+m++---mmm-++1-
-+2++t+++++++++-
-+---++++++++++-
-+++----p----++-
-+t++++---m++++-
-+++t++++++2+++-
-2--+++++--++t+-
-++---g---+++++-
-t+++++++++m--+-
-++++2++m+---++-
-+++++--g--++++-
-+2+---++++++tt-
-k+t++++---m++p-
----------------