----------------
-M+++++t++++t+p-
-+--------------
-+++++MMM++++++-
------+++-------
-++++++t+++++++-
-+--------------
-++2+++1+++++++-
-------M------+-
-++++2++M++++++-
-+--------------
-++++++M+++++++-
--------------+-
-p++++++++++++k-
----------------