----------------
-+m+p---mmm-++1-
-+2++t+++++++++-
-----++++++++++-
-+++----+----++-
-+t++++---m++++-
-+++t++++++2+++-
-2--+++++--++t+-
-++-------+++++-
-t+++++++++m--+-
-++++2++m+---++-
-+++++-----p+++-
-+2+---++++++tt-
-k+t++++---+++m-
----------------