----------------
-+m++---m-++1---
-+3++t++g++++++-
-+---++++++3+++-
-p++-------4-++-
-+t+++++++m++++-
-+++t++++++2+++-
--4-+++m+--++t+-
-++---g---++4++-
-t+++++++++m--+-
-++++3++m+---++-
-+++++--g--++++-
-+2+---++3+++tt-
-k+t++++---m++p-
----------------