----------------
-+t3+p---+++-+1-
-+++-m++-+-+++t-
--++---+++--+m+-
---t-++m++m++++-
-m+++3++++++4++-
--+++m+++t+++t+-
-++++t+4+++++++-
-+t+m++++-++-+t-
-++++t+m++m--m+-
-++---+m++t+----
-+m++-+---+++++-
----+++-p++++-t-
-mm+3+++++tt++k-
----------------