----------------
-++M+++t++++t+p-
-+--------------
-++++++++++++++-
------+++-------
-++++++t+++++++-
-+--------------
-++2+++1+++++++-
-------+------+-
-++++2+++++++++-
-+--------------
-++++++++++++++-
--------------+-
-+++++++M+++++k-
----------------