----------------
-pt3++---+++-+1-
-+++-m++-+-+++t-
--++---+++--+m+-
---t-++m++m++++-
-m++++++++++4++-
--+++m+++t+++t+-
-++++t+4+++++++-
-+t+m++++-++-+t-
-++++t+m++m--mp-
-++---+m++t+----
-+m++-+---+++++-
----+++-m++++-t-
-mm+3+++++tt++k-
----------------