----------------
-+t3++---+3+-+1-
-+++-g++-+-+++t-
--++---+3+--+m+-
---t-++m++t++++-
-+++++3+++4+4++-
--+++m+++t+++t+-
-++++t+4++++4++-
-+t+m++++-++-+t-
-+3++t+m++g--mp-
-p+-g-+m++t+----
-+m++-+---+++4+-
----+++-m+3++-t-
-+m+3+++++tt++k-
----------------