----------------
-pt3++---+3+-+1-
-+++-g++-+-+++t-
--++---+3+--+m+-
---t-++m++t++++-
-m++++3+++4+4++-
--+++m+++t+++t+-
-++++t+4++++4++-
-+t+m++++-++-+t-
-+3++t+m++g--mp-
-++-g-+m++t+----
-+m++-+---+++4+-
----+++-m+3++-t-
-mm+3+++++tt++k-
----------------