----------------
-pt2++---+++-+1-
-+++-m++-+-+++t-
--++---+++--+m+-
---t-++m++m++++-
-m++++++++++2++-
--+++m+++t+++t+-
-++++t+2+++++++-
-+t+m++++-++-+t-
-++++t+m++m--mp-
-++---+m++t+----
-+m++-+---+++++-
----+++-m++++-t-
-mm+2+++++tt++k-
----------------